8
0.0   0.0   0.0
1.0   1.0   1.0
1.0   0.0   0.0
0.0   1.0   0.0
0.0   0.0   1.0
0.596 0.462 0.329
0.501 1.0   0.0
0.0   0.6   0.0

8
0 0
1 1
1 2
1 3
1 4
0 5
0 6
0 7

3
0 0 0 0 0 0 0 0 0 0 0 0 0 0 0 0 2 0 0 0
0 0 0 0 0 0 0 0 0 0 0 0 0 0 0 0 3 0 0 0
0 0 0 0 0 0 0 0 0 0 0 0 0 0 0 0 4 0 0 0
0 0 0 0 0 0 0 0 0 0 0 0 0 0 0 0 2 0 0 0
0 0 0 0 0 0 0 0 0 0 0 0 0 0 0 0 3 0 0 0
0 0 0 0 0 0 0 0 0 0 0 0 0 0 0 0 4 0 0 0
0 0 0 0 0 0 0 0 0 0 0 0 0 0 0 0 2 0 0 0
0 0 0 0 0 0 0 0 0 0 0 0 0 0 0 0 3 0 0 0
0 0 0 0 0 0 0 0 0 0 0 0 0 0 0 0 4 0 0 0
0 0 0 0 0 0 0 0 0 0 0 0 0 0 0 0 2 0 0 0
0 0 0 0 0 0 0 0 0 0 0 0 0 0 0 0 3 0 0 0
0 0 0 0 0 0 0 0 0 0 0 0 0 0 0 0 4 0 0 0
0 0 0 0 0 0 0 0 0 0 0 0 0 0 0 0 2 0 0 0
0 0 0 0 0 0 0 0 0 0 0 0 0 0 0 0 3 0 0 0
0 0 0 0 0 0 0 0 0 0 0 0 0 0 0 0 4 1 1 1

0 0 0 0 0 0 0 6 6 0 0 0 0 6 6 0 0 0 0 0
0 0 0 0 0 0 0 0 0 6 0 0 6 0 0 0 0 0 0 0
0 0 0 0 0 0 6 6 0 0 6 6 0 0 6 6 0 0 0 0
0 0 0 0 0 6 0 0 6 6 6 6 6 6 0 0 6 0 0 0
0 0 0 0 0 0 0 0 0 0 6 6 0 0 0 0 0 0 0 0
0 0 0 0 0 0 0 6 6 6 5 5 6 6 6 0 0 0 0 0
0 0 0 0 0 0 6 0 0 5 7 7 7 0 0 6 7 0 0 0
0 0 0 0 0 0 0 0 5 7 0 0 7 7 7 0 0 7 0 0
0 0 0 0 0 0 0 0 5 0 0 7 7 7 7 7 0 0 0 0
0 0 0 0 0 0 0 5 0 0 7 0 0 5 0 0 7 0 0 0
0 0 0 0 0 0 0 5 0 7 0 0 5 0 0 0 0 7 0 0
0 0 0 0 0 0 0 5 0 0 0 5 0 0 0 0 0 0 0 0
0 0 0 0 0 0 0 0 5 0 0 5 0 0 0 0 0 0 0 0
0 0 0 0 0 0 0 0 5 0 0 0 5 0 0 0 0 0 0 0
1 1 1 1 1 1 1 1 1 1 1 1 1 1 1 1 1 1 1 1

0 0 0 4 0 0 0 0 0 0 0 0 0 0 0 0 0 0 0 0
0 0 0 3 0 0 0 0 0 0 0 0 0 0 0 0 0 0 0 0
0 0 0 2 0 0 0 0 0 0 0 0 0 0 0 0 0 0 0 0
0 0 0 4 0 0 0 0 0 0 0 0 0 0 0 0 0 0 0 0
0 0 0 3 0 0 0 0 0 0 0 0 0 0 0 0 0 0 0 0
0 0 0 2 0 0 0 0 0 0 0 0 0 0 0 0 0 0 0 0
0 0 0 4 0 0 0 0 0 0 0 0 0 0 0 0 0 0 0 0
0 0 0 3 0 0 0 0 0 0 0 0 0 0 0 0 0 0 0 0
0 0 0 2 0 0 0 0 0 0 0 0 0 0 0 0 0 0 0 0
0 0 0 4 0 0 0 0 0 0 0 0 0 0 0 0 0 0 0 0
0 0 0 3 0 0 0 0 0 0 0 0 0 0 0 0 0 0 0 0
0 0 0 2 0 0 0 0 0 0 0 0 0 0 0 0 0 0 0 0
0 0 0 4 0 0 0 0 0 0 0 0 0 0 0 0 0 0 0 0
0 0 0 3 0 0 0 0 0 0 0 0 0 0 0 0 0 0 0 0
1 1 1 2 0 0 0 0 0 0 0 0 0 0 0 0 0 0 0 0

1
10 14
